H0;1;4
R0;2;6
T0;3;0
H1;4;2
G0;5;8
W0;6;4
R1;7;1
H2;7;2
W1;7;4
T1;7;9
W2;8;6
$
# # # # # # # # # # 
# # * # * # * # * # 
# # * # * # * # * # 
# * * * * # * # * # 
# # * # # # * # * # 
# # * * * * * * * # 
# # * # * # * # * # 
# * * # * # * # * # 
# # * # # # * # # # 
# # # # # # # # # # 
