T;0;3
H;1;1
D;1;6
T;1;9
W;2;1
T;3;0
W;3;3
W;4;3
H;4;7
G;5;3
H;5;6
R;6;7
H;7;2
D;7;5
R;8;1
H;8;5
$
# # # # # # # # # # 
# * # * * * * * * # 
# * # # # * # # # # 
# * # * # * # * # # 
# * # * # * # * # # 
# * # * # * * * * # 
# * # * # * # * # # 
# * * * * * # * # # 
# * # * # * # # # # 
# # # # # # # # # # 
