T;0;1
T;1;0
W;1;3
R;1;5
T;1;9
D;3;2
H;3;7
R;3;8
W;5;1
H;5;4
H;5;6
D;6;2
G;6;8
H;7;2
W;7;8
H;8;2
$
# # # # # # # # # # 
# * * * * * * * * # 
# # * # # # # # # # 
# * * # * * * * * # 
# # * # * # # # # # 
# * * # * * * * * # 
# # * # * # # # * # 
# # * # * # * # * # 
# # * # * # * # # # 
# # # # # # # # # # 
