T;0;1
T;1;0
W;1;3
G;1;4
H;1;6
T;1;9
H;2;1
H;3;1
W;3;3
H;3;7
D;4;3
H;5;4
W;5;6
D;5;7
R;7;1
R;8;7
$
# # # # # # # # # # 
# * * * * * * * * # 
# * # # # # # # # # 
# * # * # * # * # # 
# * # * # * # * # # 
# * # * * * * * * # 
# # # * # # # # # # 
# * * * # * * * * # 
# # # # # # # * # # 
# # # # # # # # # # 
