T;0;2
T;0;3
H;1;6
T;1;9
G;2;4
W;2;8
R;3;6
H;3;7
W;3;8
H;4;8
W;5;4
R;5;6
H;6;6
H;6;8
$
# # # # # # # # # # 
# # * * * # * # * # 
# # # # * # * # * # 
# # * # * * * * * # 
# # * # # # # # * # 
# * * * * * * # * # 
# # # # # # * # * # 
# # * * * * * * * # 
# # # # # # * # # # 
# # # # # # # # # # 
