T;0;2
W;1;1
H;1;8
W;2;2
T;2;9
W;3;6
T;3;9
H;5;1
R;5;7
G;6;2
H;7;5
R;8;2
$
# # # # # # # # # # 
# * * # * * * # * # 
# # * # * # * # * # 
# # * * * # * * * # 
# # # # # # # # * # 
# * * # * # * * * # 
# # * # * # # # * # 
# * * * * * * * * # 
# # * # # # * # * # 
# # # # # # # # # # 
