T;0;1
T;1;0
H;1;2
W;1;3
G;1;7
W;1;8
H;2;7
T;3;0
R;3;7
R;5;7
H;7;2
W;7;4
$
# # # # # # # # # # 
# * * * * * # * * # 
# # # # # * # * # # 
# * * * * * * * # # 
# # # * # * # * # # 
# * * * # * # * # # 
# # # # # # # * # # 
# * * * * * * * * # 
# # # # # # # # # # 
# # # # # # # # # # 
