T;0;1
T;1;0
R;1;7
W;2;3
W;2;7
H;4;1
H;4;5
R;4;7
H;8;2
G;8;4
W;8;8
T;9;1
$
# # # # # # # # # # 
# * # # # * # * # # 
# * # * * * # * * # 
# * # # # * # # # # 
# * # * * * * * # # 
# * # # # * # # # # 
# * * * # * * * * # 
# # # * # * # # # # 
# * * * * * * * * # 
# # # # # # # # # # 
