W;1;5
T;1;9
R;2;1
T;2;9
H;3;6
H;4;3
G;5;1
H;5;4
W;5;5
W;6;1
H;6;4
H;6;5
D;7;1
R;7;6
D;8;7
T;9;2
$
# # # # # # # # # # 
# # # * * * # # * # 
# * * # * * * # * # 
# * * # # * * # # # 
# # # * # # # * * # 
# * # * * * # # * # 
# * # # * * # # * # 
# * * # # # * * # # 
# # * * * # * * * # 
# # # # # # # # # # 
