T;0;2
W;1;1
H;1;8
R;5;7
G;6;2
D;8;8
$
# # # # # # # # # # 
# * * * * * * # * # 
# # * * * * * # * # 
# * * * * * * * * # 
# * * # # # * # * # 
# * * * * # * * * # 
# * * # * # * # * # 
# * * * * * * * * # 
# # * * * * * * * # 
# # # # # # # # # # 
